11111111111111111111111111111111111111111
10000000000010001010100000001000001000001
11111111011110111010111110111011111010101
10100000000010101010100000000000001010101
10101110111000101010111111111111011111101
10101000100010001010100000000000001000001
10101111111010101010111101111111111110111
10001000000010101000101000000000001010001
11101111111110101010101011111110101010111
10101000000010101010101000000010101010101
10100011111110100011101111111011111000001
10001000000010101000101000000000101010101
11111111111111111110101101110110101010111
10000000000000001010100000100010000010001
11111111011111101010101111111110111010101
10000000001000101010101000000010001010101
11101111111101100000101011111110111011101
10000000001000001010101000000000001010001
11110111111111111111111111111111101111111
10000010101000000000101000000000000000001
10111110001011111110101111111111111101111
10000000100010000000101010000000001000001
11011110111011111111101010111111101101101
10000010100000000000001010100000000000101
11111111101111111111101011111111111110111
10000000100000000000101010000000000000001
11111110111111111011100011111110111111111
10000000000000000000101000000000000000000
11111111111111111111111111111111111111111