11111111111111111111111111111111111111111
00000000000000000000000000000010000010001
11111111111111111111111111111010110110111
10000000000000000000000000100000100000001
11111111111111110111111110101011111111101
10000000000000000000100000001010000000001
11111111111111111111111111111111111011111
10001000000000000000000000000010000000001
10101011101111111111111111101110101011101
10101010000000000010000000000000101010101
10101111111111110111111111111110101010101
10101010100000000000100010000010101010001
10101010111111011111110110110111111111101
10101010100000000000000000100010101010101
10101010111111111111111111111010101010101
10101000100000000000000010001010101010101
10101010111111111111011010111010101010101
10101010100000000000001010000010101010101
10101010111111101111111111011110101010101
10101010100000000000000000000010101010101
10101010101111111111111111111110001010101
10100010100000000000000000000010101000101
10101010111111110111111111111110101010101
10101010000000000000000000000010101010101
11111110111111111111111111111110101110101
10000000000000000000000000000010100000101
11101011111111111111111111111110101010001
10001000000000000000000000000010101010100
11111111111111111111111111111111111111111