11111111111111111111111111111111111111111
10100000000010000010000000000000000000001
10111011111011101110111111101111111111101
10000010001000100010101000001000001000101
11111111101110101010101011111011101010101
10000000000010101000101000100000101010101
10111111111110101111101110111110101010101
10000000001000101000100010100000101010001
11111011101011101010101010101111101011111
10001010001010001010101010100000101000101
10101110111010111010101010101110111110101
10100010100010000010101010100010100000101
10111010101110111110111010101110101111101
10001000100010100010000010101000101000001
10101011111011101011111110101010101111101
10101010001010001010000010101010100000001
10101110101010111010111010111010111111101
10100000100010001000101010100010001000001
10111111111110101111101010101111111011111
10000000100000101000001000100010001000001
11111110111111101010111111111010101111101
10000010100000101010000000001010100000001
10111110101110101011111011101010111111111
10100000101010001010100010000010001000001
10101111101011111010101111101111101111101
10100000101000001010101000101000101000101
10111110101011111010101010111010101010101
10000000001000000000100010000010000010000
11111111111111111111111111111111111111111