11111111111111111111111111111111111111111
00000000001000000010001000100000000000001
11111111101011111010101010101110111111101
10000010001010001000101010101010000000101
10111010111011101111101010101011111110101
10101010100010000000100010000010000010101
10101010101110111011111111111010111010101
10100010101000001010000010001010001010101
10111110101111101110111010101111101010101
10000010100000001000100000100000001000101
10111010111111101011111111111110111111101
10001010001010001000001000000000100010001
11111011101010111111101110111111101011101
10000010001000100000100010100000001000101
10111110111011101110111011101111111110111
10000010001000001000101000000000000010001
11111011101111111011101111111111111110101
10001000101000001010000000001000000010101
10101110101111101010101111111011111010101
10100000101000001010101000100010000010101
10111011101011111010111010101110111111101
10100010001010001000100010101010100000001
10101110111010101110101110101010101111111
10101000100000100000100010001010100000001
10111011111111101111111011111010101111101
10001010000000101000000010000010100010001
10101010111110111011111110111110111110101
10100000100000000010000000000000000000100
11111111111111111111111111111111111111111