11111111111111111111111111111111111111111
10000000000010000010000000101000101000001
10101011111010101111101010101110101011111
10101000001010100010001010100000000000001
10111110101110101010111111111010111011111
10100010100000101000000000100010100000001
10101111111011101011111111101011111011111
10000000001010001000000000001000100000101
10101111111011111111111111111011111111101
10100000101010100000101000001010001010101
11101011101110101111101011111110111010101
10001000000000000000000000001000001000001
11101010111110111011111111111011101011111
10001010000010001000100000100000100010101
10111011111110111110111110101011101110101
10100000000010000010100000001000100000001
11111011111111111111111011101011111110111
10000000000000001010000000101000101010001
10111011111011111010101110101111101011101
10001000001000001000100010100010000010001
10111010111011111011101111111111101111111
10001010001000000000100000101000000000101
11101110101111101010111111101011111111101
10101000101000101010100010000010000000001
10101110101011111011101010101010111110101
10001000100000001000101010101000000010101
11111111101110111010101110111110101111111
10000000000010001010000000000010100000000
11111111111111111111111111111111111111111