11111111111111111111111111111111111111111
00101000001010001010101000001010101000001
10101110111010111010101110111010101110111
10001010000000000000000000000000000010001
10111010111111101110111110111011111110111
10000000000000100010000010001000001000001
10101111111010101110101111101011101110111
10100000001010101010100000101000100000001
10111111101111111010111010101110111010111
10000000100010000010101010100010001010001
10111010111110111111101111111110111010101
10100010000010001010100010000010100010101
10111011101110111010101111101011111011101
10100000100000101000101000001000101010001
11111011101111101011101011111111101111111
10100000100000000000100000000010101000101
10101111101110101110101111101110101011101
10000000100010100010000010001000000000001
11101011111111101010111111101011111110111
10001000001010001010001000100000000010101
10111111101011101110111011111110111011101
10000010000010000010100010000010001010001
10101011101111101111101010111110111110111
10101000100010000000001000000010000000001
10101011111110101111101111101110111011111
10101000001000100000100000101000001010001
11111011111010111110101010111011101010111
10000000001010000010101010001000101000000
11111111111111111111111111111111111111111