11111111111111111111111111111111111111111
10000000100000000000000000000000000010001
10101111101111101011111111111111101110101
10100000000000101000000000000000100000101
10111010111010111010101011111110111110111
10100010001010101010101000001010000010001
10111010101010101011101010101011111110101
10001010101010001010101010100000100010101
10101110101111111110101011111110111011111
10101010100000101000101000100010000010101
11101011101011101010111011101010101010101
10000000101010000010001000001010101000001
10101010111110101011111110111011111110111
10101010000000101000000010001000000010001
11101110111110111011111110111011111011101
10000010100000100000001010101000100000101
10101111111010111011111011101011101010111
10100000101010101000100000001000101010001
10111111101111101010101011111011111011111
10101000100010000010001000001010101000001
10101011101011111110101110101010101010111
10000000101010100000101010101000001010001
10111110101110101110111010111010111111111
10000010000000101000000010001010000010001
10111111101111111110101111111011101010101
10100000000000001010100000001010001010101
11101010111010111011101110111011101110101
10001010001010000010001000001000100000100
11111111111111111111111111111111111111111