11111111111111111111111111111111111111111
10100000100010100000100010000000000000101
10101111101110111011101111101011111111101
10000000001000000000000010101000000000001
10101110111010111111111110101111111010111
10100010100010001010100000100010001010101
11101010111011101010101111101110101110101
10101010000000100000000000000000100010001
10101010111010101011101111101111111111111
10001010001010101010000010101000000000001
10101011111011111011101110101011101111111
10101000001010001010000010001010101000101
10101110111110111111111111111010111011101
10100010001000101010101010000010000000101
10111110101011101010101011101110111010101
10000010100000001010101000100010001010001
10101011101010111010101110101010101011111
10101000101010001000000000001000101010101
10101010101111111010101111111011111110101
10101010100000000010101000100010000000001
11111011101010111011111010111111101111101
10000010001010001000001010001000000000101
11101011101111101010101011111010101111111
10001000100000101010100000000010101010001
11101010101011111110111111101011111010111
10001010101000000010000010001000000000001
10111010101110111010101011101111101010101
10100010101000001010101010000000101010100
11111111111111111111111111111111111111111